16 12 3
111111111111111
000000000000001
101111111111101
101000000000101
101000000000101
101000000000101
101000000000101
101000000000101
101111111111101
100000000000000
111111111111111

111111111111111
111111111111111
111111111111111
111111111111111
111111111111111
111111111111111
111111111111111
111111111111111
111111111111111
111111111111111
111111111111111

111111111111111
111111111111111
111111111111111
111111111111111
111111111111111
111111111111111
111111111111111
111111111111111
111111111111111
111111111111111
111111111111111